111111111
1PE111E01
10C000C11
111111111
