111111111111111111
100100000teE111111
100P01111100111111
1C001110CCc011aa11
111111111111111111
