111111111111111111
100100000E01111111
100P01110000111111
1C001110CC00110011
111111111111111111
