1111111111
10CE000001
10000P0001
1111111111